XXXXXXXXXXXXXXXXXXXX
X                  X
X                  X
XXXX XXX    XXX XXXX
XXXX XXX    XXX XXXX
XXXX XXX    XXX XXXX
                    
 X               X  
                    
XXXX XXX    XXX XXXX
XXXX XXX    XXX XXXX
XXXX XXX    XXX XXXX
X                  X
X                  X
XXXXXXXXXXXXXXXXXXXX