XXXXXXXXXXXXXXXXXXXX
X                  X
X                  X
XXXX XXX    XXX XXXX
XXXX XXX    XXX XXXX
XXXX XXX    XXX XXXX
                    
1X                X2
                    
XXXX XXX    XXX XXXX
XXXX XXX    XXX XXXX
XXXX XXX    XXX XXXX
X                  X
X                  X
XXXXXXXXXXXXXXXXXXXX