XXXXXXXXXXXXXXXXXXXX
X                  X
X B              B X
XXXX XXX    XXX XXXX
XXXX XXX    XXX XXXX
XXXX XXX    XXX XXXX
                    
1X                X2
                    
XXXX XXX    XXX XXXX
XXXX XXX    XXX XXXX
XXXX XXX    XXX XXXX
X B              B X
X                  X
XXXXXXXXXXXXXXXXXXXX