XXXXXXXXXXXXXXXXXXXX
X        1         X
X XX   XX XX    XX X
X                  X
X X XXX  X  XXX  X X
X X X   XXX   X  X X
X X XXX     XXX  X X
X                  X
X X XX       XX  X X
X X X   XXX   X  X X
X X XX   X   XX  X X
X                  X
X XX   XX XX    XX X
X        2         X
XXXXXXXXXXXXXXXXXXXX