XXXXXXXXXXXXXXXXXXX
X                 X
X X  XXXXXXXXX  X X
X X             X X
X XX           XX X
X XXX         XXX X
XXXXXXXXXXXXXXXXXXX
X    1       2    X
XXXXXXXXXXXXXXXXXXX
X XXX         XXX X
X XX           XX X
X X             X X
X X  XXXXXXXXX  X X
X                 X
XXXXXXXXXXXXXXXXXXX