XXXXXXXXXXXXXXXXXXX
X        1        X
X X  XXXXXXXXX  X X
X X             X X
X XX           XX X
X XXX         XXX X
X XXXX       XXXX X
X                 X
X XXXX       XXXX X
X XXX         XXX X
X XX           XX X
X X             X X
X X  XXXXXXXXX  X X
X        2        X
XXXXXXXXXXXXXXXXXXX