  XXXXXXXXXXXXXXXXXX
        XXXXXXXXXXXX
XX            XXXXXX
XXXX           XXXXX
XXXXXXXX       XXXXX
XXXXXXXXXX       XXX
XXXX       XXX  XXXX
XXXXXXX    XXX    XX
XXXXXXX         XXXX
XXXXXXXXX     XXXXXX
XXXXXX        XXXXXX
XXXXXXXXXXXX  XXXXXX
XXX           XXXXXX
XXXXXXXXXXXXXXXXXXXX
XXXXXXXXXXXXXXXXXXXX