1 XXXXXXXXXXXXXXXXXX
                   X
X   XXXX    XXXX   X
X                  X
X       XXXX     B X
X                  X
X   XXXX    XXXX   X
X                  X
X       XXXX       X
X                  X
X B XXXX    XXXX   X
X                  X
X       XXXX       X
X                   
XXXXXXXXXXXXXXXXXX 2