XXXXXXXXX  XXXXXXXXX
X1                 X
X                  X
X    X   XX   X    X
X                  X
XX                XX
X                  X
X B  XX      XX  B X
X                  X
XX                XX
X                  X
X    X   XX   X    X
X                  X
X                 2X
XXXXXXXXX  XXXXXXXXX