1 XXXXXXXXXXXXXXXXXX
                   X
XX X X X X X X X X X
X                  X
X       XXXX     B X
X                  X
X                  X
X                  X
X                  X
X                  X
X B     XXXX       X
X                  X
X X X X X X X X X XX
X                   
XXXXXXXXXXXXXXXXXX 2